Privet - Oi (Informal)
Ya Henrique - Eu sou henrique

Kak ty? Como voce está? (informal)
Horosho - Bem

Apresentando
Ya Luiz Henrique - Eu sou
A ty? - E voce? - singular

Sim e nao
da - sim
net (niyet) - não

A а - pronunciado /a/ como em "azul"
Е е - pronunciado /je/ como em "iemanjá"
К к - pronunciado /k/ como em "canguru
М м - pronunciado /m/ como em "mãe"
О о - pronunciado /o/ como em "óculos"
С с - pronunciado /s/ como em "sorvete"
Т т - pronunciado /t/ como em "táxi

cok (sok) - suco
KOT - gato
TaKoe - tal

Б б - pronunciado /b/ como em balão
босс - boss chefe

Г г - pronunciado /g/ como em gato
год ano

Д д - pronunciado /d/ como em dado
дом - casa
дед - avô

Ё ё - pronunciado /jɔ/ como em "Nova Iorque" (io)
ёжик - ouriço

Ж ж - pronunciado /ʒ/ como em junto (j)
жаба - sapo


Мёд - mel
бегемот - hipopótamo
мода - moda
сода - bicarbonato de sódio
